NO ./textures/brick.xpm
SO ./textures/blue.xpm
WE ./textures/wood.xpm
EA ./textures/grey.xpm

F 86,125,70
C 132,206,235

111111
100101
101001
1100N1
111111